*************************************************************
*S *     *                 *     *           *        *     *
*  *  *  *  *************  *  *  *  *******  *  ****  *  *  *
*     *  *     *     *     *  *     *        *  *     *  *  *
*******  *  ****  *  *  ****  *******  *******  *******  *  *
*     *        *  *        *  *     *     *              *  *
*  **********  *  **********  *  *  ****  *  *************  *
*     *        *     *     *  *  *  *     *           *     *
****  *  **********  ****  *  *  *  *******************  ****
*     *     *     *     *  *     *              *     *     *
*  *******  *  *******  *  *  ****************  *  *  *  *  *
*  *        *  *     *        *              *  *  *     *  *
*  *  *  ****  *  *  ****  ****  **********  *  ****  ****  *
*     *     *     *        *     *        *           *     *
**********  ****************  ****  ****  ****  *******  ****
*  *        *              *     *     *        *        *  *
*  *  *************  **********  ****  *  ****  *  *******  *
*     *        *  *  *           *     *  *  *  *        *  *
*******  ****  *  *  *  **********  ****  *  *  *******  *  *
*        *     *        *           *     *     *     *  *  *
*  **********  **********  **********************  *  *  *  *
*  *        *                          *           *     *  *
*  *******  *******  *  *************  *  ****************  *
*  *        *     *  *  *           *  *              *     *
*  *  *******  ****  ****  *******  *  *************  *  ****
*     *     *     *     *  *        *     *        *        *
*  *******  *  *  ****  *  ****  *******  *  *************  *
*        *     *  *     *  *     *        *        *        *
*******  *******  *  ****  *  *******************  **********
*     *     *     *  *     *  *        *        *     *     *
*  *  *  *  *  ****  *  ****  *  ****  ****  *******  *  ****
*  *  *  *        *     *  *     *        *           *     *
*  *  *******************  *******  *  *  *******  *******  *
*  *                          *     *  *        *        *  *
*  **********************  *  *  ****  *******  ****  *  *  *
*  *        *     *     *  *     *  *     *     *  *  *  *  *
*  *  ****  *  *  *  ****  *******  *  *  *  ****  *  *  *  *
*  *     *  *  *  *     *  *     *  *  *  *  *     *  *  *  *
*  ****  *  *  *  ****  *  *  *  *  *  *  ****  *  *  *  *  *
*        *     *        *     *     *  *        *     *    E*
*************************************************************
