*******************************************************************************************
*S    *        *                 *  *        *                 *           *           *  *
****  *******  *  *************  *  *  ****  *  *************  *  *******  *  *******  *  *
*  *     *     *     *     *     *     *        *     *        *     *     *  *     *  *  *
*  ****  *  **********  *  *  **********  *  *******  *  **********  *  ****  *  *  *  *  *
*  *     *        *     *        *        *           *     *        *        *  *        *
*  *  ****  *  ****  *******  *  *  *******************  *  *  ****************  ****  *  *
*  *  *     *     *  *        *  *     *     *     *     *  *  *           *     *  *  *  *
*  *  *  ****  *  *  *  *************  *  *  *  *  *  ****  *  *  *******  *  ****  *  *  *
*  *  *  *     *     *  *        *     *  *  *  *  *     *     *        *  *  *        *  *
*  *  *  *  **********  *  ****  *  ****  *  *  *  *******************  *  ****  *******  *
*  *     *        *     *     *     *     *     *     *                 *        *     *  *
*  *******  ****  **********  *******  *************  *  *************************  ****  *
*           *  *     *     *        *  *           *  *  *     *        *           *     *
**********  *  ****  ****  *******  *  *  *******  *  *  *  *  *******  **********  *  ****
*           *        *     *        *  *  *     *     *  *  *  *     *     *     *  *  *  *
*  ****************  *  ****  *******  *  ****  *******  ****  *  *  ****  ****  *  *  *  *
*  *     *  *     *  *     *        *  *        *  *     *     *  *  *  *           *     *
*  *  *  *  *  *  *******  *  *******  **********  *  ****  ****  *  *  *******  **********
*  *  *  *     *        *        *     *     *        *     *  *  *  *        *  *        *
*  *  *  *************  *******  *  ****  *  *  *******  ****  *  *  *******  *  ****  ****
*  *  *        *     *           *     *  *     *     *  *        *  *     *        *     *
*  *  *******  *  *  *  *************  *  *******  *  *  *  *  ****  ****  *******  ****  *
*  *  *     *  *  *  *        *        *        *  *     *  *     *  *     *        *  *  *
*  *  *  *  *  *  *  ****  *  *  *************  *  *******  ****  *  *  *  *  *******  *  *
*     *  *     *  *        *     *     *     *  *              *  *     *     *           *
*******  *******  ****  *************  ****  *  ****  **********  *************  **********
*     *  *     *     *  *                    *        *           *  *           *        *
*  *  *  *  *  ****  *  *  **********  ****************  **********  *  *  *******  ****  *
*  *  *     *  *     *     *           *     *  *     *     *     *     *  *     *  *     *
*  *  *******  *  **********  **********  *  *  *  ****  *  *  *  *******  *  *  *  ****  *
*  *           *     *     *           *  *     *     *  *     *        *  *  *  *     *  *
*  ****************  *  *************  *  **********  **********  ****  *  *  *  ****  *  *
*     *     *        *     *        *  *                    *  *     *  *     *        *  *
****  *  *  *  **********  *  ****  *  *******  ****  ****  *  ****  ****  *************  *
*     *  *  *     *     *  *  *  *     *  *     *  *  *     *  *           *        *     *
*  ****  *  ****  ****  *  *  *  *******  *  ****  *  *******  *  **********  ****  *  ****
*  *     *     *  *        *        *  *     *        *     *  *     *     *     *     *  *
*  *  ****  *  *  *  *  *******  *  *  ****  *  *******  *  *  *******  *  ****  *******  *
*  *  *     *     *  *  *        *  *        *  *  *     *  *  *     *  *           *     *
*  *  *  **********  *  **********  **********  *  *  ****  *  *  *  **********  ****  *  *
*     *              *     *        *        *     *  *     *     *     *     *        *  *
*************  *  *******  *  *******  *  *  ****  *  ****  *  *******  ****  **********  *
*     *     *  *     *     *        *  *  *     *     *     *        *     *     *        *
****  *  ****  ****  *************  ****  *  *******  *  ****************  ****  *  *******
*     *        *  *     *     *     *     *  *        *  *                 *     *        *
*  *************  ****  *  *  *  ****  ****  *  ****  *  *  ****  **********  **********  *
*        *     *     *     *  *     *  *     *     *  *     *     *           *           *
*******  *  *******  *******  ****  *  *  *******  *  *******  ****  ****  *  *  ****  ****
*     *  *     *     *           *  *  *  *     *  *        *        *     *  *  *     *  *
*  *  *  *  *  *  **********  *  *  *  *  *  ****  *******  *  *******  *******  *  ****  *
*  *  *     *  *        *     *  *  *  *           *     *  *  *     *  *  *     *        *
*  *  *  ****  *******  *******  *  *  *************  *  *  ****  ****  *  *  *************
*  *     *        *  *           *     *     *        *        *           *  *     *     *
*  **********  *  *  *******************  *  *  *  **********  *************  ****  ****  *
*  *     *     *     *           *     *  *  *  *  *     *  *  *        *                 *
*  *  *  *  **********  *******  *  *  *  ****  ****  *  *  *  *  ****  **********  *******
*  *  *  *           *  *  *     *  *  *     *        *  *     *     *     *     *  *     *
*  *  *  **********  *  *  *  *  *  *  *  *  **********  **********  ****  *  *  *  ****  *
*     *           *     *     *     *     *                          *        *  *       E*
*******************************************************************************************
