**********************************************
*S          *                    *  *        *
**********  *  *************  *  *  *  ****  *
*        *  *  *           *  *  *  *     *  *
*  *  ****  *  **********  ****  *  ****  *  *
*  *  *     *           *  *     *        *  *
*  *  *  *************  *  *  *  **********  *
*  *     *           *  *     *        *     *
*  *******  *******  *  *************  *  ****
*     *     *        *     *     *           *
****  *  *  *  **********  *  *  **********  *
*     *  *  *     *        *  *     *        *
*  ****  *******  *  *******  ****  *  *******
*     *     *     *  *     *     *  *        *
****  ****  *  ****  *  *  *******  *******  *
*  *        *     *     *              *     *
*  ****  *******  ****************  *  *******
*  *  *     *  *                    *        *
*  *  ****  *  ****************************  *
*  *        *  *           *                 *
*  *  ****  *  *  *******  *  ****************
*     *     *  *  *        *  *              *
*  ****  ****  *  *  *******  *  **********  *
*     *     *  *  *  *  *     *  *     *     *
****  *******  ****  *  *  ****  *  *  *  ****
*  *     *     *        *     *  *  *  *     *
*  ****  *  ****  *  *******  *  *  *******  *
*     *        *  *  *     *     *  *        *
*  *  ****  *  *  *  *  *  *******  *  *******
*  *        *     *     *           *       E*
**********************************************
