+--+--+--+--+--+--+--+--+--+--+--+--+--+--+--+
            |                    |  |        |
+--+--+--+  +  +--+--+--+--+  +  +  +  +--+  +
|        |  |  |           |  |  |  |     |  |
+  +  +--+  +  +--+--+--+  +--+  +  +--+  +  +
|  |  |     |           |  |     |        |  |
+  +  +  +--+--+--+--+  +  +  +  +--+--+--+  +
|  |     |           |  |     |        |     |
+  +--+--+  +--+--+  +  +--+--+--+--+  +  +--+
|     |     |        |     |     |           |
+--+  +  +  +  +--+--+--+  +  +  +--+--+--+  +
|     |  |  |     |        |  |     |        |
+  +--+  +--+--+  +  +--+--+  +--+  +  +--+--+
|     |     |     |  |     |     |  |        |
+--+  +--+  +  +--+  +  +  +--+--+  +--+--+  +
|  |        |     |     |              |     |
+  +--+  +--+--+  +--+--+--+--+--+  +  +--+--+
|  |  |     |  |                    |        |
+  +  +--+  +  +--+--+--+--+--+--+--+--+--+  +
|  |        |  |           |                 |
+  +  +--+  +  +  +--+--+  +  +--+--+--+--+--+
|     |     |  |  |        |  |              |
+  +--+  +--+  +  +  +--+--+  +  +--+--+--+  +
|     |     |  |  |  |  |     |  |     |     |
+--+  +--+--+  +--+  +  +  +--+  +  +  +  +--+
|  |     |     |        |     |  |  |  |     |
+  +--+  +  +--+  +  +--+--+  +  +  +--+--+  +
|     |        |  |  |     |     |  |        |
+  +  +--+  +  +  +  +  +  +--+--+  +  +--+--+
|  |        |     |     |           |
+--+--+--+--+--+--+--+--+--+--+--+--+--+--+--+