+--+--+--+--+--+--+--+--+--+--+--+--+--+--+--+--+--+--+--+--+
|S |     |                 |     |           |        |     |
+  +  +  +  +--+--+--+--+  +  +  +  +--+--+  +  +--+  +  +  +
|     |  |     |     |     |  |     |        |  |     |  |  |
+--+--+  +  +--+  +  +  +--+  +--+--+  +--+--+  +--+--+  +  +
|     |        |  |        |  |     |     |              |  |
+  +--+--+--+  +  +--+--+--+  +  +  +--+  +  +--+--+--+--+  +
|     |        |     |     |  |  |  |     |           |     |
+--+  +  +--+--+--+  +--+  +  +  +  +--+--+--+--+--+--+  +--+
|     |     |     |     |  |     |              |     |     |
+  +--+--+  +  +--+--+  +  +  +--+--+--+--+--+  +  +  +  +  +
|  |        |  |     |        |              |  |  |     |  |
+  +  +  +--+  +  +  +--+  +--+  +--+--+--+  +  +--+  +--+  +
|     |     |     |        |     |        |           |     |
+--+--+--+  +--+--+--+--+--+  +--+  +--+  +--+  +--+--+  +--+
|  |        |              |     |     |        |        |  |
+  +  +--+--+--+--+  +--+--+--+  +--+  +  +--+  +  +--+--+  +
|     |        |  |  |           |     |  |  |  |        |  |
+--+--+  +--+  +  +  +  +--+--+--+  +--+  +  +  +--+--+  +  +
|        |     |        |           |     |     |     |  |  |
+  +--+--+--+  +--+--+--+  +--+--+--+--+--+--+--+  +  +  +  +
|  |        |                          |           |     |  |
+  +--+--+  +--+--+  +  +--+--+--+--+  +  +--+--+--+--+--+  +
|  |        |     |  |  |           |  |              |     |
+  +  +--+--+  +--+  +--+  +--+--+  +  +--+--+--+--+  +  +--+
|     |     |     |     |  |        |     |        |        |
+  +--+--+  +  +  +--+  +  +--+  +--+--+  +  +--+--+--+--+  +
|        |     |  |     |  |     |        |        |        |
+--+--+  +--+--+  +  +--+  +  +--+--+--+--+--+--+  +--+--+--+
|     |     |     |  |     |  |        |        |     |     |
+  +  +  +  +  +--+  +  +--+  +  +--+  +--+  +--+--+  +  +--+
|  |  |  |        |     |  |     |        |           |     |
+  +  +--+--+--+--+--+--+  +--+--+  +  +  +--+--+  +--+--+  +
|  |                          |     |  |        |        |  |
+  +--+--+--+--+--+--+--+  +  +  +--+  +--+--+  +--+  +  +  +
|  |        |     |     |  |     |  |     |     |  |  |  |  |
+  +  +--+  +  +  +  +--+  +--+--+  +  +  +  +--+  +  +  +  +
|  |     |  |  |  |     |  |     |  |  |  |  |     |  |  |  |
+  +--+  +  +  +  +--+  +  +  +  +  +  +  +--+  +  +  +  +  +
|        |     |        |     |     |  |        |     |    E|
+--+--+--+--+--+--+--+--+--+--+--+--+--+--+--+--+--+--+--+--+