+--+--+--+--+--+--+--+--+--+--+--+--+--+--+--+--+--+--+--+--+--+--+--+--+--+--+--+--+--+--+
|S    |        |                 |  |        |                 |           |           |  |
+--+  +--+--+  +  +--+--+--+--+  +  +  +--+  +  +--+--+--+--+  +  +--+--+  +  +--+--+  +  +
|  |     |     |     |     |     |     |        |     |        |     |     |  |     |  |  |
+  +--+  +  +--+--+--+  +  +  +--+--+--+  +  +--+--+  +  +--+--+--+  +  +--+  +  +  +  +  +
|  |     |        |     |        |        |           |     |        |        |  |        |
+  +  +--+  +  +--+  +--+--+  +  +  +--+--+--+--+--+--+  +  +  +--+--+--+--+--+  +--+  +  +
|  |  |     |     |  |        |  |     |     |     |     |  |  |           |     |  |  |  |
+  +  +  +--+  +  +  +  +--+--+--+--+  +  +  +  +  +  +--+  +  +  +--+--+  +  +--+  +  +  +
|  |  |  |     |     |  |        |     |  |  |  |  |     |     |        |  |  |        |  |
+  +  +  +  +--+--+--+  +  +--+  +  +--+  +  +  +  +--+--+--+--+--+--+  +  +--+  +--+--+  +
|  |     |        |     |     |     |     |     |     |                 |        |     |  |
+  +--+--+  +--+  +--+--+--+  +--+--+  +--+--+--+--+  +  +--+--+--+--+--+--+--+--+  +--+  +
|           |  |     |     |        |  |           |  |  |     |        |           |     |
+--+--+--+  +  +--+  +--+  +--+--+  +  +  +--+--+  +  +  +  +  +--+--+  +--+--+--+  +  +--+
|           |        |     |        |  |  |     |     |  |  |  |     |     |     |  |  |  |
+  +--+--+--+--+--+  +  +--+  +--+--+  +  +--+  +--+--+  +--+  +  +  +--+  +--+  +  +  +  +
|  |     |  |     |  |     |        |  |        |  |     |     |  |  |  |           |     |
+  +  +  +  +  +  +--+--+  +  +--+--+  +--+--+--+  +  +--+  +--+  +  +  +--+--+  +--+--+--+
|  |  |  |     |        |        |     |     |        |     |  |  |  |        |  |        |
+  +  +  +--+--+--+--+  +--+--+  +  +--+  +  +  +--+--+  +--+  +  +  +--+--+  +  +--+  +--+
|  |  |        |     |           |     |  |     |     |  |        |  |     |        |     |
+  +  +--+--+  +  +  +  +--+--+--+--+  +  +--+--+  +  +  +  +  +--+  +--+  +--+--+  +--+  +
|  |  |     |  |  |  |        |        |        |  |     |  |     |  |     |        |  |  |
+  +  +  +  +  +  +  +--+  +  +  +--+--+--+--+  +  +--+--+  +--+  +  +  +  +  +--+--+  +  +
|     |  |     |  |        |     |     |     |  |              |  |     |     |           |
+--+--+  +--+--+  +--+  +--+--+--+--+  +--+  +  +--+  +--+--+--+  +--+--+--+--+  +--+--+--+
|     |  |     |     |  |                    |        |           |  |           |        |
+  +  +  +  +  +--+  +  +  +--+--+--+  +--+--+--+--+--+  +--+--+--+  +  +  +--+--+  +--+  +
|  |  |     |  |     |     |           |     |  |     |     |     |     |  |     |  |     |
+  +  +--+--+  +  +--+--+--+  +--+--+--+  +  +  +  +--+  +  +  +  +--+--+  +  +  +  +--+  +
|  |           |     |     |           |  |     |     |  |     |        |  |  |  |     |  |
+  +--+--+--+--+--+  +  +--+--+--+--+  +  +--+--+--+  +--+--+--+  +--+  +  +  +  +--+  +  +
|     |     |        |     |        |  |                    |  |     |  |     |        |  |
+--+  +  +  +  +--+--+--+  +  +--+  +  +--+--+  +--+  +--+  +  +--+  +--+  +--+--+--+--+  +
|     |  |  |     |     |  |  |  |     |  |     |  |  |     |  |           |        |     |
+  +--+  +  +--+  +--+  +  +  +  +--+--+  +  +--+  +  +--+--+  +  +--+--+--+  +--+  +  +--+
|  |     |     |  |        |        |  |     |        |     |  |     |     |     |     |  |
+  +  +--+  +  +  +  +  +--+--+  +  +  +--+  +  +--+--+  +  +  +--+--+  +  +--+  +--+--+  +
|  |  |     |     |  |  |        |  |        |  |  |     |  |  |     |  |           |     |
+  +  +  +--+--+--+  +  +--+--+--+  +--+--+--+  +  +  +--+  +  +  +  +--+--+--+  +--+  +  +
|     |              |     |        |        |     |  |     |     |     |     |        |  |
+--+--+--+--+  +  +--+--+  +  +--+--+  +  +  +--+  +  +--+  +  +--+--+  +--+  +--+--+--+  +
|     |     |  |     |     |        |  |  |     |     |     |        |     |     |        |
+--+  +  +--+  +--+  +--+--+--+--+  +--+  +  +--+--+  +  +--+--+--+--+--+  +--+  +  +--+--+
|     |        |  |     |     |     |     |  |        |  |                 |     |        |
+  +--+--+--+--+  +--+  +  +  +  +--+  +--+  +  +--+  +  +  +--+  +--+--+--+  +--+--+--+  +
|        |     |     |     |  |     |  |     |     |  |     |     |           |           |
+--+--+  +  +--+--+  +--+--+  +--+  +  +  +--+--+  +  +--+--+  +--+  +--+  +  +  +--+  +--+
|     |  |     |     |           |  |  |  |     |  |        |        |     |  |  |     |  |
+  +  +  +  +  +  +--+--+--+  +  +  +  +  +  +--+  +--+--+  +  +--+--+  +--+--+  +  +--+  +
|  |  |     |  |        |     |  |  |  |           |     |  |  |     |  |  |     |        |
+  +  +  +--+  +--+--+  +--+--+  +  +  +--+--+--+--+  +  +  +--+  +--+  +  +  +--+--+--+--+
|  |     |        |  |           |     |     |        |        |           |  |     |     |
+  +--+--+--+  +  +  +--+--+--+--+--+--+  +  +  +  +--+--+--+  +--+--+--+--+  +--+  +--+  +
|  |     |     |     |           |     |  |  |  |  |     |  |  |        |                 |
+  +  +  +  +--+--+--+  +--+--+  +  +  +  +--+  +--+  +  +  +  +  +--+  +--+--+--+  +--+--+
|  |  |  |           |  |  |     |  |  |     |        |  |     |     |     |     |  |     |
+  +  +  +--+--+--+  +  +  +  +  +  +  +  +  +--+--+--+  +--+--+--+  +--+  +  +  +  +--+  +
|     |           |     |     |     |     |                          |        |  |       E|
+--+--+--+--+--+--+--+--+--+--+--+--+--+--+--+--+--+--+--+--+--+--+--+--+--+--+--+--+--+--+